Core|development/HMCore/Core|0|C++|LINK_LIBS-NOTFOUND
Foundation|development/HMCore/Foundation|0|C++|LINK_LIBS-NOTFOUND
HMEngine|development/HMCore/HMEngine|0|C++|LINK_LIBS-NOTFOUND
RendererCore|development/HMRender/RendererCore|0|C++|LINK_LIBS-NOTFOUND
RendererDX11|development/HMRender/RendererDX11|0|C++|LINK_LIBS-NOTFOUND
RendererDX12|development/HMRender/RendererDX12|0|C++|LINK_LIBS-NOTFOUND
RendererFoundation|development/HMRender/RendererFoundation|0|C++|LINK_LIBS-NOTFOUND
RendererVulkan|development/HMRender/RendererVulkan|0|C++|LINK_LIBS-NOTFOUND
ShaderCompilerDXC|development/HMRender/ShaderCompilerDXC|0|C++|LINK_LIBS-NOTFOUND
ShaderCompilerHLSL|development/HMRender/ShaderCompilerHLSL|0|C++|LINK_LIBS-NOTFOUND
Texture|development/HMRender/Texture|0|C++|LINK_LIBS-NOTFOUND
Imgui|development/ThirdParty/Imgui|0|C++|LINK_LIBS-NOTFOUND
OpenFBX|development/ThirdParty/OpenFBX|0|C++|LINK_LIBS-NOTFOUND
PipelineSet|development/ThirdParty/PipelineSet|0|C++|LINK_LIBS-NOTFOUND
RuntimeCompiledCPlusPlus|development/ThirdParty/RuntimeCompiledCPlusPlus|0|C++|LINK_LIBS-NOTFOUND
ads|development/ThirdParty/ads|0|C++|LINK_LIBS-NOTFOUND
d3dx12|development/ThirdParty/d3dx12|0|C++|LINK_LIBS-NOTFOUND
meshoptimizer|development/ThirdParty/meshoptimizer|0|C++|LINK_LIBS-NOTFOUND
optick|development/ThirdParty/optick|0|C++|LINK_LIBS-NOTFOUND
stb_image|development/ThirdParty/stb_image|0|C++|LINK_LIBS-NOTFOUND
tinyexr|development/ThirdParty/tinyexr|0|C++|LINK_LIBS-NOTFOUND
zstd|development/ThirdParty/zstd|0|C++|LINK_LIBS-NOTFOUND
GuiFoundation|development/Tools/Libs/GuiFoundation|0|C++|LINK_LIBS-NOTFOUND
ToolsFoundation|development/Tools/Libs/ToolsFoundation|0|C++|LINK_LIBS-NOTFOUND
FoundationTest|development/UnitTests/FoundationTest|0|C++|LINK_LIBS-NOTFOUND
FoundationTest_Plugin1|development/UnitTests/FoundationTest_Plugin1|0|C++|LINK_LIBS-NOTFOUND
FoundationTest_Plugin2|development/UnitTests/FoundationTest_Plugin2|0|C++|LINK_LIBS-NOTFOUND
TestFramework|development/UnitTests/TestFramework|0|C++|LINK_LIBS-NOTFOUND
ToolsFoundationTest|development/UnitTests/ToolsFoundationTest|0|C++|LINK_LIBS-NOTFOUND
Utilities|development/Utilities|0|C++|LINK_LIBS-NOTFOUND
